125 125 125 125 125 125 125 125 125 125 125 125 125 125 125 125 125 125 125 125 125 125 125 125 125 125 125 125 125 125 125 125 125 125 125 125 125 125 125 125 125 125 125 125 125 
125 125 125 125 125 125 125 125 125 125 125 125 125 125 125 125 125 125 125 125 125 125 125 125 125 125 125 125 125 125 125 125 125 125 125 125 125 125 125 125 125 125 125 125 125 
125 125 125 125 125 125 125 125 125 125 125 125 125 125 125 125 125 125 125 125 125 125 125 125 125 125 125 125 125 125 125 125 125 125 125 125 125 125 125 125 125 125 125 125 125 
125 125 125 125 125 125 125 125 125 125 125 125 125 125 125 125 125 125 125 125 125 125 125 125 125 125 125 125 125 125 125 125 125 125 125 125 125 125 125 125 125 125 125 125 125 
125 125 125 125 125 125 125 125 125 125 125 125 125 125 125 125 125 125 125 125 125 125 125 125 125 125 125 125 125 125 125 125 125 125 125 125 125 125 125 125 125 125 125 125 125 
125 125 125 125 125 125 125 125 125 125 125 125 125 125 125 125 125 125 125 125 125 125 125 125 125 125 125 125 125 125 125 125 125 125 125 125 125 125 125 125 125 125 125 125 125 
125 125 125 125 125 125 125 125 125 125 125 125 125 125 125 125 125 125 125 125 125 125 125 125 125 125 125 125 125 125 125 125 125 125 125 125 125 125 125 125 125 125 125 125 125 
125 125 125 125 125 125 125 125 125 125 125 125 125 125 125 125 125 125 125 125 125 125 125 125 125 125 125 125 125 125 125 125 125 125 125 125 125 125 125 125 125 125 125 125 125 
125 125 125 125 125 125 125 125 125 125 125 125 125 125 125 125 125 125 125 125 125 125 125 125 125 125 125 125 125 125 125 125 125 125 125 125 125 125 125 125 125 125 125 125 125 
125 125 125 125 125 125 125 125 125 125 125 125 125 125 125 125 125 125 125 125 125 125 125 125 125 125 125 125 125 125 125 125 125 125 125 125 125 125 125 125 125 125 125 125 125 
125 125 125 125 125 125 125 125 125 125 125 125 125 125 125 125 125 125 125 125 125 125 125 125 125 125 125 125 125 125 125 125 125 125 125 125 125 125 125 125 125 125 125 125 125 
125 125 125 125 125 125 125 125 125 125 125 125 125 125 125 125 125 125 125 125 125 125 125 125 125 125 125 125 125 125 125 125 125 125 125 125 125 125 125 125 125 125 125 125 125 
17 18 18 18 18 18 18 18 18 19 125 125 77 78 78 78 78 79 125 125 17 18 18 18 18 18 18 18 18 19 125 125 77 81 81 81 81 82 125 125 125 125 125 125 125 
32 33 33 33 33 33 33 33 33 34 125 125 125 125 125 125 125 125 125 125 32 33 33 33 33 33 33 33 33 34 125 125 125 125 125 125 125 125 125 125 125 125 125 125 125 
32 33 33 33 33 33 33 33 33 34 125 125 125 125 125 125 125 125 125 125 32 33 33 33 33 33 33 33 33 34 125 125 125 125 125 125 125 125 125 125 125 125 125 125 125 
47 48 48 48 48 48 48 48 48 49 125 125 125 125 125 125 125 125 125 125 47 48 48 48 48 48 48 48 48 49 125 125 125 125 125 125 125 125 125 125 125 125 125 125 125 
125 125 125 125 125 125 125 125 125 125 125 125 77 78 78 78 78 79 125 125 125 125 125 125 125 125 125 125 125 125 125 125 77 78 78 78 78 79 125 125 125 125 125 125 125 
125 125 125 125 125 125 125 125 125 125 125 125 125 125 125 125 125 125 125 125 125 125 125 125 125 125 125 125 125 125 125 125 125 125 125 125 125 125 125 125 125 125 125 125 125 
125 125 125 125 125 125 125 125 125 125 125 125 125 125 125 125 125 125 125 125 125 125 125 125 125 125 125 125 125 125 125 125 125 125 125 125 125 125 125 125 125 125 125 125 125 
125 125 125 125 125 125 125 125 125 125 125 125 125 125 125 125 125 125 125 125 125 125 125 125 125 125 125 125 125 125 125 125 125 125 125 125 125 125 125 125 125 125 125 125 125 
125 125 125 125 125 125 125 125 125 125 125 125 77 78 78 78 81 82 125 125 125 125 125 125 125 125 125 125 125 125 125 125 77 78 78 78 78 79 125 125 125 125 125 125 125 
125 125 125 125 125 125 125 125 125 125 125 125 125 125 125 125 125 125 125 125 125 125 125 125 125 125 125 125 125 125 125 125 125 125 125 125 125 125 125 125 125 125 125 125 125 
125 125 125 125 125 125 125 125 125 125 125 125 125 125 125 125 125 125 125 125 125 125 125 125 125 125 125 125 125 125 125 125 125 125 125 125 125 125 125 125 125 125 125 125 125 
125 125 125 125 125 125 125 125 125 125 125 125 125 125 125 125 125 125 125 125 125 125 125 125 125 125 125 125 125 125 125 125 125 125 125 125 125 125 125 125 125 125 125 125 125 
125 125 125 125 125 125 125 125 125 125 125 125 77 78 81 81 81 82 125 125 125 125 125 125 125 125 125 125 125 125 125 125 80 81 81 81 81 82 125 125 125 125 125 125 125 
125 125 125 125 125 125 125 125 125 125 125 125 125 125 125 125 125 125 125 125 125 125 125 125 125 125 125 125 125 125 125 125 125 125 125 125 125 125 125 125 125 125 125 125 125 
17 18 18 18 18 18 18 18 18 19 125 125 125 125 125 125 125 125 125 125 17 18 18 18 18 18 18 18 18 19 125 125 125 125 125 125 125 125 125 125 17 18 18 18 19 
32 33 33 33 33 33 33 33 33 34 125 125 125 125 125 125 125 125 125 125 32 33 33 33 33 33 33 33 33 34 125 125 125 125 125 125 125 125 125 125 32 33 33 33 34 
32 33 33 33 33 33 33 33 33 34 125 125 125 125 125 125 125 125 125 125 32 33 33 33 33 33 33 33 33 34 125 125 125 125 125 125 125 125 125 125 32 33 33 33 34 
47 48 48 48 48 48 48 48 48 49 84 85 86 87 84 85 86 87 88 89 47 48 48 48 48 48 48 48 48 49 84 85 84 85 86 87 88 89 88 89 47 48 48 48 49
