109 109 109 109 109 109 109 109 109 109 109 109 109 109 109 109 109 109 109 109 109 109 109 109 109 109 109 109 109 109 109 109 109 109 109 109 109 109 109 109 109 109 109 109 109 
109 109 109 109 109 109 109 109 109 109 109 109 109 109 109 109 109 109 109 109 109 109 109 109 109 109 109 109 109 109 109 109 109 109 109 109 109 109 109 109 109 109 109 109 109 
109 109 109 109 109 109 109 109 109 109 109 109 109 109 109 109 109 109 109 109 109 109 109 109 109 109 109 109 109 109 109 109 109 109 109 109 109 109 109 109 109 109 109 109 109 
109 109 109 109 109 109 109 109 109 109 109 109 109 109 109 109 109 109 109 109 109 109 109 109 109 109 109 109 109 109 109 109 109 109 109 109 109 109 109 109 109 109 109 109 109 
109 109 109 109 109 109 109 109 109 109 109 109 109 109 109 109 109 109 109 109 109 109 109 109 109 109 109 109 109 109 109 109 109 109 109 109 109 109 109 109 109 109 109 109 109 
109 109 109 109 109 109 109 109 109 109 109 109 109 109 109 109 109 109 109 109 109 109 109 109 109 109 109 109 109 109 109 109 109 109 109 109 109 109 109 109 109 109 109 109 109 
109 109 109 109 109 109 109 109 109 109 109 109 109 109 109 109 109 109 109 109 109 109 109 109 109 109 109 109 109 109 109 109 109 109 109 109 109 109 109 109 109 109 109 109 109 
109 109 77 82 17 18 18 18 18 18 18 18 18 17 77 82 17 18 18 18 18 18 18 18 18 18 18 18 19 77 82 17 18 18 18 18 18 18 18 18 19 77 82 109 109 
109 109 109 109 32 33 33 33 33 33 33 33 33 32 110 110 32 33 33 33 33 33 33 33 33 33 33 33 34 109 109 32 33 33 33 33 33 33 33 33 34 109 109 109 109 
109 109 109 109 32 33 33 33 33 33 33 33 33 32 110 110 32 33 33 33 33 33 33 33 33 33 33 33 34 109 109 32 33 33 33 33 33 33 33 33 34 109 109 109 109 
109 109 109 109 47 48 48 48 48 48 48 48 48 47 110 110 47 48 48 48 48 48 48 48 48 48 48 48 49 109 109 47 48 48 48 48 48 48 48 48 49 109 109 109 109 
109 109 77 82 109 109 109 109 109 109 109 109 109 109 77 82 109 109 109 109 109 109 109 109 109 109 109 109 109 77 82 109 109 109 109 109 109 109 109 109 109 77 82 109 109 
109 109 109 109 109 109 109 109 109 109 109 109 109 109 109 109 109 109 109 109 109 109 109 109 109 109 109 109 109 109 109 109 109 109 109 109 109 109 109 109 109 109 109 109 109 
109 109 109 109 109 109 109 109 109 109 109 109 109 109 109 109 109 109 109 109 109 109 109 109 109 109 109 109 109 109 109 109 109 109 109 109 109 109 109 109 109 109 109 109 109 
109 109 109 109 109 109 109 109 109 109 109 109 109 109 109 109 109 109 109 109 109 109 109 109 109 109 109 109 109 109 109 109 109 109 109 109 109 109 109 109 109 109 109 109 109 
109 109 77 82 109 109 109 109 109 109 109 109 109 109 77 82 109 109 109 109 109 109 109 109 109 109 109 109 109 77 82 109 109 109 109 109 109 109 109 109 109 77 82 109 109 
109 109 109 109 109 109 109 109 109 109 109 109 109 109 109 109 109 109 109 109 109 109 109 109 109 109 109 109 109 109 109 109 109 109 109 109 109 109 109 109 109 109 109 109 109 
109 109 109 109 109 109 109 109 109 109 109 109 109 109 109 109 109 109 109 109 109 109 109 109 109 109 109 109 109 109 109 109 109 109 109 109 109 109 109 109 109 109 109 109 109 
109 109 109 109 109 109 109 109 109 109 109 109 109 109 109 109 109 109 109 109 109 109 109 109 109 109 109 109 109 109 109 109 109 109 109 109 109 109 109 109 109 109 109 109 109 
109 109 77 82 109 109 109 109 109 109 109 109 109 109 77 82 109 109 109 109 109 109 109 109 109 109 109 109 109 77 82 109 109 109 109 109 109 109 109 109 109 77 82 109 109 
109 109 109 109 109 109 109 109 109 109 109 109 109 109 109 109 109 109 109 109 109 109 109 109 109 109 109 109 109 109 109 109 109 109 109 109 109 109 109 109 109 109 109 109 109 
109 109 109 109 109 109 109 109 109 109 109 109 109 109 109 109 109 109 109 109 109 109 109 109 109 109 109 109 109 109 109 109 109 109 109 109 109 109 109 109 109 109 109 109 109 
109 109 109 109 109 109 109 109 109 109 109 109 109 109 109 109 109 109 109 109 109 109 109 109 109 109 109 109 109 109 109 109 109 109 109 109 109 109 109 109 109 109 109 109 109 
109 109 24 26 109 109 109 109 109 109 109 109 109 109 24 26 109 109 109 109 109 109 109 109 109 109 109 109 109 24 26 109 109 109 109 109 109 109 109 109 109 24 26 109 109 
109 109 39 41 109 109 109 109 109 109 109 109 109 109 39 41 109 109 109 109 109 109 109 109 109 109 109 109 109 39 41 109 109 109 109 109 109 109 109 109 109 39 41 109 109 
109 109 54 56 109 109 109 109 109 109 109 109 109 109 54 56 84 85 86 87 88 89 84 84 85 86 87 88 89 54 56 109 109 109 109 109 109 109 109 109 109 54 56 109 109 
17 18 18 18 18 18 18 18 18 18 18 18 18 18 18 18 18 18 18 18 18 18 18 18 18 18 18 18 18 18 18 18 18 18 18 18 18 18 18 18 18 18 18 18 19 
32 33 33 33 33 33 33 33 33 33 33 33 33 33 33 33 33 33 33 33 33 33 33 33 33 33 33 33 33 33 33 33 33 33 33 33 33 33 33 33 33 33 33 33 34 
32 33 33 33 33 33 33 33 33 33 33 33 33 33 33 33 33 33 33 33 33 33 33 33 33 33 33 33 33 33 33 33 33 33 33 33 33 33 33 33 33 33 33 33 34 
47 48 48 48 48 48 48 48 48 48 48 48 48 48 48 48 48 48 48 48 48 48 48 48 48 48 48 48 48 48 48 48 48 48 48 48 48 48 48 48 48 48 48 48 49