109 109 109 109 109 109 109 109 109 109 109 109 109 109 109 109 109 109 109 109 109 109 109 109 109 109 109 109 109 109 109 109 109 109 109 109 109 109 109 109 109 109 109 109 109 
109 109 109 109 109 109 109 109 109 109 109 109 109 109 109 109 109 109 109 109 109 109 109 109 109 109 109 109 109 109 109 109 109 109 109 109 109 109 109 109 109 109 109 109 109 
109 109 109 109 109 109 109 109 109 109 109 109 109 109 109 109 109 109 109 109 109 109 109 109 109 109 109 109 109 109 109 109 109 109 109 109 109 109 109 109 109 109 109 109 109 
109 109 109 109 109 109 109 109 109 109 109 109 109 109 109 109 109 109 109 109 109 109 109 109 109 109 109 109 109 109 109 109 109 109 109 109 109 109 109 109 109 109 109 109 109 
109 109 109 109 109 109 109 109 109 109 109 109 109 109 109 109 109 109 109 109 109 109 109 109 109 109 109 109 109 109 109 109 109 109 109 109 109 109 109 109 109 109 109 109 109 
109 109 109 109 109 109 109 109 109 109 109 109 109 109 109 109 109 109 109 109 109 109 109 109 109 109 109 109 109 109 109 109 109 109 109 109 109 109 109 109 109 109 109 109 109 
17 18 18 18 18 18 19 109 109 109 109 109 109 109 109 109 109 109 109 17 18 18 18 18 18 19 109 109 109 109 109 109 109 109 109 109 109 109 17 18 18 18 18 18 19 
32 33 33 33 33 33 34 109 109 109 109 109 109 109 109 109 109 109 109 32 33 33 33 33 33 34 109 109 109 109 109 109 109 109 109 109 109 109 32 33 33 33 33 33 34 
32 33 33 33 33 33 34 109 109 77 78 79 109 109 77 78 79 109 109 32 33 33 33 33 33 34 109 109 77 78 79 109 109 77 78 79 109 109 32 33 33 33 33 33 34 
47 48 48 48 48 48 49 109 109 109 109 109 109 109 109 109 109 109 109 47 48 48 48 48 48 49 109 109 109 109 109 109 109 109 109 109 109 109 47 48 48 48 48 48 49 
109 109 109 109 109 109 109 109 109 109 109 109 109 109 109 109 109 109 109 109 109 109 109 109 109 109 109 109 109 109 109 109 109 109 109 109 109 109 109 109 109 109 109 109 109 
109 109 109 109 109 109 109 109 109 109 109 109 109 109 109 109 109 109 109 109 109 109 109 109 109 109 109 109 109 109 109 109 109 109 109 109 109 109 109 109 109 109 109 109 109 
109 109 109 109 109 109 109 109 109 77 78 79 109 109 77 78 79 109 109 109 109 109 109 109 109 109 109 109 77 78 79 109 109 77 78 79 109 109 109 109 109 109 109 109 109 
109 109 109 109 109 109 109 109 109 109 109 109 109 109 109 109 109 109 109 109 109 109 109 109 109 109 109 109 109 109 109 109 109 109 109 109 109 109 109 109 109 109 109 109 109 
109 109 109 109 109 109 109 109 109 109 109 109 109 109 109 109 109 109 109 109 109 109 109 109 109 109 109 109 109 109 109 109 109 109 109 109 109 109 109 109 109 109 109 109 109 
109 109 109 109 109 109 109 109 109 109 109 109 109 109 109 109 109 109 109 109 109 109 109 109 109 109 109 109 109 109 109 109 109 109 109 109 109 109 109 109 109 109 109 109 109 
17 18 18 18 18 18 19 109 109 77 78 79 109 109 77 78 79 109 109 17 18 18 18 18 18 19 109 109 77 78 79 109 109 77 78 79 109 109 17 18 18 18 18 18 19 
32 33 33 33 33 33 34 109 109 109 109 109 109 109 109 109 109 109 109 32 33 33 33 33 33 34 109 109 109 109 109 109 109 109 109 109 109 109 32 33 33 33 33 33 34 
32 33 33 33 33 33 34 109 109 109 109 109 109 109 109 109 109 109 109 32 33 33 33 33 33 34 109 109 109 109 109 109 109 109 109 109 109 109 32 33 33 33 33 33 34 
47 48 48 48 48 48 49 109 109 109 109 109 109 109 109 109 109 109 109 47 48 48 48 48 48 49 109 109 109 109 109 109 109 109 109 109 109 109 47 48 48 48 48 48 49 
109 109 109 109 109 109 109 109 109 77 78 79 109 109 77 78 79 109 109 109 109 109 109 109 109 109 109 109 77 78 79 109 109 77 78 79 109 109 109 109 109 109 109 109 109 
109 109 109 109 109 109 109 109 109 109 109 109 109 109 109 109 109 109 109 109 109 109 109 109 109 109 109 109 109 109 109 109 109 109 109 109 109 109 109 109 109 109 109 109 109 
109 109 109 109 109 109 109 109 109 109 109 109 109 109 109 109 109 109 109 109 109 109 109 109 109 109 109 109 109 109 109 109 109 109 109 109 109 109 109 109 109 109 109 109 109 
109 109 109 109 109 109 109 109 109 109 109 109 109 109 109 109 109 109 109 109 109 109 109 109 109 109 109 109 109 109 109 109 109 109 109 109 109 109 109 109 109 109 109 109 109 
109 109 109 109 109 109 109 109 109 77 78 79 109 109 77 78 79 109 109 109 109 109 109 109 109 109 109 109 77 78 79 109 109 77 78 79 109 109 109 109 109 109 109 109 109 
109 109 109 109 109 109 109 109 109 109 109 109 109 109 109 109 109 109 109 109 109 109 109 109 109 109 109 109 109 109 109 109 109 109 109 109 109 109 109 109 109 109 109 109 109 
17 18 18 18 18 18 19 109 109 109 109 109 109 109 109 109 109 109 109 17 18 18 18 18 18 19 109 109 109 109 109 109 109 109 109 109 109 109 17 18 18 18 18 18 19 
32 33 33 33 33 33 34 109 109 109 109 109 109 109 109 109 109 109 109 32 33 33 33 33 33 34 109 109 109 109 109 109 109 109 109 109 109 109 32 33 33 33 33 33 34 
32 33 33 33 33 33 34 109 109 109 109 109 109 109 109 109 109 109 109 32 33 33 33 33 33 34 109 109 109 109 109 109 109 109 109 109 109 109 32 33 33 33 33 33 34 
47 48 48 48 48 48 49 84 85 86 87 88 89 84 85 86 87 88 89 47 48 48 48 48 48 49 85 86 87 88 89 84 85 86 87 88 89 84 47 48 48 48 48 48 49